LEVEL
8 10
TOOLS
MIRROR 6
PRISM 1
EMITTER 180
MAP
0 0 0 0 1 0 0 0 
0 1 0 0 1 0 1 1 
6 0 0 0 0 0 4 1 
0 0 0 0 1 0 0 1 
0 0 0 0 0 1 0 1 
1 0 5 0 0 0 0 0 
0 0 1 1 0 2 0 1 
0 1 0 1 0 0 0 0
0 0 0 1 0 0 0 0 
1 0 0 0 0 1 0 1 
END
