LEVEL
6 13
TOOLS
MIRROR 6
PRISM 1
EMITTER 180
MAP
1 0 0 0 0 1 
0 0 4 0 0 0 
1 0 0 6 0 0 
0 0 5 0 0 0 
0 0 0 0 0 0 
0 0 0 0 0 0
0 0 0 0 0 0 
0 0 0 0 0 0 
0 0 0 0 0 0 
0 0 0 0 0 0 
0 0 2 0 0 0 
0 0 0 0 0 0 
1 0 0 0 0 1 
END
