LEVEL
9 9
TOOLS
MIRROR 2
PRISM 1
EMITTER 270
MAP
1 0 1 0 1 0 0 1 1 
0 0 0 0 0 0 1 1 0 
0 0 1 0 0 0 0 0 0 
1 0 0 0 0 6 0 5 0 
0 1 0 0 0 0 0 0 1 
0 0 0 0 1 0 0 0 0 
0 0 0 2 0 0 0 0 0 
0 1 0 0 0 0 0 1 1 
1 0 1 1 0 0 4 1 1
END
