LEVEL
9 9
TOOLS
MIRROR 5
PRISM 1
EMITTER 90
MAP
1 0 0 6 0 0 0 1 1 
0 1 0 1 0 0 0 0 1 
0 1 0 0 0 0 0 0 0 
1 0 0 2 0 0 0 1 0 
0 1 0 1 1 4 0 0 1 
1 0 0 0 0 0 0 1 0 
0 1 0 5 0 0 0 0 1 
0 1 1 0 0 1 1 1 0 
1 0 1 0 0 0 0 0 1
END
